1,1,1,1,1,1,1,1,1,1
1,,,n1,,,,,,1
1,,,,,,,,,1
1,,,3,,,,,,1
1,,,3,,,,,,1
1,,,3,,,,,,1
1,,,3,,,,,,1
1,,,3,,,,,,1
1,,,,,,,,,1
1,,,,,,n2,,,1
1,,,,,,,,,1
1,,,,,,,,,1
1,,,,,,,,,1
1,1,1,1,1,1,1,1,1,1
