1,1,1,1,1,1,1,1,1,1,1,1,1
1,,,,,,,,,,,,1
1,,,n77,,,,,,,,,1
1,,,,,2,,,,3,,,1
1,,,,,2,,,,3,,,1
1,,,,,2,,,,3,,,1
1,,,,,2,,,,3,,,1
1,,,,,2,,,,3,,,1
1,,,,,2,,,,3,,,1
1,,,,,,,,,,,,1
1,,,,,,,,,,,,1
1,,,n76,,,,,,,,,1
1,,,,,,,,,,,,1
1,,,,,,,,,,,,1
1,,,,,,,,,,,,1
1,,,,,,,,,,,,1
1,1,1,1,1,1,1,1,1,1,1,1,1
